x xxxxxxx
x xx    x
x  x xx x
xx   xx x
x  xxxx x
xx      x
xx xx xxx